lead_variant,chromosome,start,finish,cohort,length
GS_DUP_CNV_1_248683299_248687529,chr1,248683299,248687529,control,4230
GS_DUP_CNV_1_248639866_248642282,chr1,248639866,248642282,control,2416
GS_DUP_CNV_1_248639866_248644860,chr1,248639866,248644860,control,4994
GS_DUP_CNV_1_248633936_248636968,chr1,248633936,248636968,control,3032
GS_DUP_CNV_1_248628814_248636052,chr1,248628814,248636052,control,7238
GS_DUP_CNV_1_248620423_248631251,chr1,248620423,248631251,control,10828
GS_DUP_CNV_1_248570361_248573925,chr1,248570361,248573925,control,3564
GS_DUP_CNV_1_248569961_248572375,chr1,248569961,248572375,control,2414
GS_DUP_CNV_1_247823690_248076359,chr1,247823690,248076359,control,252669
GS_DUP_CNV_1_206570557_206574503,chr1,206570557,206574503,control,3946
GS_DUP_CNV_1_206490711_206492746,chr1,206490711,206492746,control,2035
GS_DUP_CNV_3_197869966_197873123,chr3,197869966,197873123,control,3157
GS_DUP_CNV_1_196907471_196910829,chr1,196907471,196910829,control,3358
GS_DUP_CNV_2_196092780_196097291,chr2,196092780,196097291,control,4511
GS_DUP_CNV_3_195470972_195476063,chr3,195470972,195476063,control,5091
GS_DUP_CNV_3_195468322_195470821,chr3,195468322,195470821,control,2499
GS_DUP_CNV_3_195452004_195456683,chr3,195452004,195456683,control,4679
GS_DUP_CNV_3_195437919_195440668,chr3,195437919,195440668,cases,2749
GS_DUP_CNV_3_195437869_195445972,chr3,195437869,195445972,control,8103
GS_DUP_CNV_3_195431046_195437261,chr3,195431046,195437261,control,6215
GS_DUP_CNV_3_195430326_195433461,chr3,195430326,195433461,cases,3135
GS_DUP_CNV_3_195422116_195426699,chr3,195422116,195426699,cases,4583
GS_DUP_CNV_3_195420306_195428699,chr3,195420306,195428699,cases,8393
GS_DUP_CNV_3_195416251_195421560,chr3,195416251,195421560,control,5309
GS_DUP_CNV_3_195409242_195412150,chr3,195409242,195412150,cases,2908
GS_DUP_CNV_2_194135906_194138205,chr2,194135906,194138205,control,2299
GS_DUP_CNV_4_190879564_190881691,chr4,190879564,190881691,control,2127
GS_DUP_CNV_4_190853848_190856711,chr4,190853848,190856711,control,2863
GS_DUP_CNV_4_190821391_190893785,chr4,190821391,190893785,control,72394
GS_DUP_CNV_4_190760907_190763756,chr4,190760907,190763756,control,2849
GS_DUP_CNV_4_190684427_190714488,chr4,190684427,190714488,control,30061
GS_DUP_CNV_4_190677062_190681026,chr4,190677062,190681026,control,3964
GS_DUP_CNV_4_190673162_190677961,chr4,190673162,190677961,control,4799
GS_DUP_CNV_4_190672562_190677261,chr4,190672562,190677261,control,4699
GS_DUP_CNV_4_190667112_190669961,chr4,190667112,190669961,control,2849
GS_DUP_CNV_4_190657468_190661269,chr4,190657468,190661269,control,3801
GS_DUP_CNV_4_190654361_190656584,chr4,190654361,190656584,control,2223
GS_DUP_CNV_4_190644390_190654260,chr4,190644390,190654260,control,9870
GS_DUP_CNV_4_190638440_190641439,chr4,190638440,190641439,control,2999
GS_DUP_CNV_4_190638390_190649489,chr4,190638390,190649489,control,11099
GS_DUP_CNV_4_190638340_190642639,chr4,190638340,190642639,control,4299
GS_DUP_CNV_4_190632004_190635339,chr4,190632004,190635339,control,3335
GS_DUP_CNV_4_190626453_190633889,chr4,190626453,190633889,control,7436
GS_DUP_CNV_4_190622755_190630003,chr4,190622755,190630003,control,7248
GS_DUP_CNV_4_190617469_190624554,chr4,190617469,190624554,control,7085
GS_DUP_CNV_4_190615769_190621194,chr4,190615769,190621194,control,5425
GS_DUP_CNV_4_190613369_190620194,chr4,190613369,190620194,control,6825
GS_DUP_CNV_4_190601201_190605666,chr4,190601201,190605666,control,4465
GS_DUP_CNV_4_190598751_190603393,chr4,190598751,190603393,control,4642
GS_DUP_CNV_4_190588773_190592472,chr4,190588773,190592472,control,3699
GS_DUP_CNV_4_190586239_190596398,chr4,190586239,190596398,control,10159
GS_DUP_CNV_4_190583739_190588438,chr4,190583739,190588438,control,4699
GS_DUP_CNV_4_190578639_190585238,chr4,190578639,190585238,control,6599
GS_DUP_CNV_4_190575191_190578938,chr4,190575191,190578938,control,3747
GS_DUP_CNV_4_190573758_190577738,chr4,190573758,190577738,control,3980
GS_DUP_CNV_4_190567469_190581838,chr4,190567469,190581838,control,14369
GS_DUP_CNV_4_190563504_190566954,chr4,190563504,190566954,control,3450
GS_DUP_CNV_4_190556898_190561446,chr4,190556898,190561446,control,4548
GS_DUP_CNV_4_190551274_190560996,chr4,190551274,190560996,control,9722
GS_DUP_CNV_4_190548551_190552473,chr4,190548551,190552473,control,3922
GS_DUP_CNV_4_190543992_190556897,chr4,190543992,190556897,control,12905
GS_DUP_CNV_4_190543242_190547914,chr4,190543242,190547914,control,4672
GS_DUP_CNV_4_190155759_190158533,chr4,190155759,190158533,control,2774
GS_DUP_CNV_2_181696042_181698356,chr2,181696042,181698356,control,2314
GS_DUP_CNV_5_177087831_177090806,chr5,177087831,177090806,control,2975
GS_DUP_CNV_5_175467819_175471162,chr5,175467819,175471162,control,3343
GS_DUP_CNV_5_175465936_175470631,chr5,175465936,175470631,control,4695
GS_DUP_CNV_5_175364774_175371017,chr5,175364774,175371017,control,6243
GS_DUP_CNV_5_175353041_175355162,chr5,175353041,175355162,control,2121
GS_DUP_CNV_5_175352891_175360473,chr5,175352891,175360473,control,7582
GS_DUP_CNV_5_175348502_175350698,chr5,175348502,175350698,control,2196
GS_DUP_CNV_5_175345066_175351068,chr5,175345066,175351068,control,6002
GS_DUP_CNV_5_175337781_175652723,chr5,175337781,175652723,control,314942
GS_DUP_CNV_6_169650059_169658558,chr6,169650059,169658558,control,8499
GS_DUP_CNV_6_167774749_167785977,chr6,167774749,167785977,control,11228
GS_DUP_CNV_1_157140937_157179648,chr1,157140937,157179648,control,38711
GS_DUP_CNV_X_154803557_154852914,chrX,154803557,154852914,control,49357
GS_DUP_CNV_X_154785400_154789987,chrX,154785400,154789987,control,4587
GS_DUP_CNV_X_154667909_154685859,chrX,154667909,154685859,control,17950
GS_DUP_CNV_7_153766344_153778386,chr7,153766344,153778386,control,12042
GS_DUP_CNV_6_153742231_153747088,chr6,153742231,153747088,control,4857
GS_DUP_CNV_6_153742231_153752114,chr6,153742231,153752114,control,9883
GS_DUP_CNV_7_153701313_153705360,chr7,153701313,153705360,control,4047
GS_DUP_CNV_7_153690660_153697559,chr7,153690660,153697559,control,6899
GS_DUP_CNV_1_149303319_149309653,chr1,149303319,149309653,control,6334
GS_DUP_CNV_1_149298489_149302429,chr1,149298489,149302429,control,3940
GS_DUP_CNV_1_149296652_149309703,chr1,149296652,149309703,control,13051
GS_DUP_CNV_1_149270388_149275365,chr1,149270388,149275365,control,4977
GS_DUP_CNV_1_149266713_149271494,chr1,149266713,149271494,control,4781
GS_DUP_CNV_1_149258515_149283970,chr1,149258515,149283970,control,25455
GS_DUP_CNV_1_149232722_149240400,chr1,149232722,149240400,control,7678
GS_DUP_CNV_1_149224335_149227514,chr1,149224335,149227514,control,3179
GS_DUP_CNV_1_149222083_149226060,chr1,149222083,149226060,control,3977
GS_DUP_CNV_1_149211484_149213533,chr1,149211484,149213533,control,2049
GS_DUP_CNV_1_149206720_149208908,chr1,149206720,149208908,control,2188
GS_DUP_CNV_1_149203481_149206519,chr1,149203481,149206519,control,3038
GS_DUP_CNV_1_149019686_149023919,chr1,149019686,149023919,control,4233
GS_DUP_CNV_1_148944004_148953497,chr1,148944004,148953497,control,9493
GS_DUP_CNV_1_148940838_148943183,chr1,148940838,148943183,control,2345
GS_DUP_CNV_1_148940195_148944603,chr1,148940195,148944603,control,4408
GS_DUP_CNV_1_148931563_148934485,chr1,148931563,148934485,control,2922
GS_DUP_CNV_1_148916889_148930305,chr1,148916889,148930305,control,13416
GS_DUP_CNV_X_148846844_148906340,chrX,148846844,148906340,control,59496
GS_DUP_CNV_1_148555597_148562001,chr1,148555597,148562001,cases,6404
GS_DUP_CNV_1_148554772_148556884,chr1,148554772,148556884,cases,2112
GS_DUP_CNV_1_147390803_147393131,chr1,147390803,147393131,control,2328
GS_DUP_CNV_1_146494423_147386943,chr1,146494423,147386943,control,892520
GS_DUP_CNV_1_146485075_146489211,chr1,146485075,146489211,control,4136
GS_DUP_CNV_1_145643806_145832123,chr1,145643806,145832123,control,188317
GS_DUP_CNV_1_145102967_145108612,chr1,145102967,145108612,control,5645
GS_DUP_CNV_1_145100767_145103366,chr1,145100767,145103366,control,2599
GS_DUP_CNV_1_145086362_145088761,chr1,145086362,145088761,control,2399
GS_DUP_CNV_1_145084862_145087461,chr1,145084862,145087461,control,2599
GS_DUP_CNV_1_145079289_145085561,chr1,145079289,145085561,control,6272
GS_DUP_CNV_1_145055965_145061853,chr1,145055965,145061853,control,5888
GS_DUP_CNV_1_145042545_145047033,chr1,145042545,145047033,control,4488
GS_DUP_CNV_1_145040845_145049490,chr1,145040845,145049490,control,8645
GS_DUP_CNV_1_145037204_145040544,chr1,145037204,145040544,control,3340
GS_DUP_CNV_1_145021136_145028189,chr1,145021136,145028189,control,7053
GS_DUP_CNV_1_145021036_145024435,chr1,145021036,145024435,cases,3399
GS_DUP_CNV_1_144998923_145013965,chr1,144998923,145013965,control,15042
GS_DUP_CNV_1_144991453_144995822,chr1,144991453,144995822,cases,4369
GS_DUP_CNV_1_144986435_144995522,chr1,144986435,144995522,control,9087
GS_DUP_CNV_4_144951767_144999932,chr4,144951767,144999932,control,48165
GS_DUP_CNV_1_144950904_144954570,chr1,144950904,144954570,control,3666
GS_DUP_CNV_1_144940621_144949351,chr1,144940621,144949351,control,8730
GS_DUP_CNV_1_144936162_144941870,chr1,144936162,144941870,control,5708
GS_DUP_CNV_4_144925198_144928060,chr4,144925198,144928060,control,2862
GS_DUP_CNV_1_144923402_144930927,chr1,144923402,144930927,control,7525
GS_DUP_CNV_1_144923202_144925225,chr1,144923202,144925225,control,2023
GS_DUP_CNV_1_144920287_144933902,chr1,144920287,144933902,control,13615
GS_DUP_CNV_1_144915508_144925000,chr1,144915508,144925000,control,9492
GS_DUP_CNV_1_144842102_144844381,chr1,144842102,144844381,control,2279
GS_DUP_CNV_1_144675338_144677697,chr1,144675338,144677697,control,2359
GS_DUP_CNV_1_144675338_144680419,chr1,144675338,144680419,control,5081
GS_DUP_CNV_1_144530192_144533095,chr1,144530192,144533095,control,2903
GS_DUP_CNV_X_144372237_144380640,chrX,144372237,144380640,control,8403
GS_DUP_CNV_1_144049618_144052976,chr1,144049618,144052976,control,3358
GS_DUP_CNV_7_143541072_143548605,chr7,143541072,143548605,control,7533
GS_DUP_CNV_1_142628856_142634263,chr1,142628856,142634263,control,5407
GS_DUP_CNV_1_142615935_142618035,chr1,142615935,142618035,control,2100
GS_DUP_CNV_7_141760366_141765362,chr7,141760366,141765362,control,4996
GS_DUP_CNV_9_141083104_141089275,chr9,141083104,141089275,control,6171
GS_DUP_CNV_9_141076788_141089819,chr9,141076788,141089819,control,13031
GS_DUP_CNV_9_141072501_141075440,chr9,141072501,141075440,control,2939
GS_DUP_CNV_X_140979593_140991347,chrX,140979593,140991347,control,11754
GS_DUP_CNV_X_140964827_140983234,chrX,140964827,140983234,control,18407
GS_DUP_CNV_X_140895963_140919542,chrX,140895963,140919542,control,23579
GS_DUP_CNV_X_140858030_140868328,chrX,140858030,140868328,control,10298
GS_DUP_CNV_X_140778250_140796122,chrX,140778250,140796122,control,17872
GS_DUP_CNV_9_140776079_140783375,chr9,140776079,140783375,control,7296
GS_DUP_CNV_8_140603540_140606967,chr8,140603540,140606967,control,3427
GS_DUP_CNV_5_140476510_140481496,chr5,140476510,140481496,control,4986
GS_DUP_CNV_X_140336620_140350170,chrX,140336620,140350170,control,13550
GS_DUP_CNV_X_140218898_140230498,chrX,140218898,140230498,control,11600
GS_DUP_CNV_X_140208008_140217262,chrX,140208008,140217262,control,9254
GS_DUP_CNV_7_139180150_139198070,chr7,139180150,139198070,control,17920
GS_DUP_CNV_8_138742685_138744684,chr8,138742685,138744684,control,1999
GS_DUP_CNV_10_135351391_135378782,chr10,135351391,135378782,control,27391
GS_DUP_CNV_10_135250035_135329927,chr10,135250035,135329927,control,79892
GS_DUP_CNV_11_134942354_134945453,chr11,134942354,134945453,control,3099
GS_DUP_CNV_11_134933609_134939295,chr11,134933609,134939295,control,5686
GS_DUP_CNV_3_134814451_134817248,chr3,134814451,134817248,control,2797
GS_DUP_CNV_X_134752090_134759086,chrX,134752090,134759086,control,6996
GS_DUP_CNV_X_134749559_134766359,chrX,134749559,134766359,control,16800
GS_DUP_CNV_11_134720345_134722846,chr11,134720345,134722846,control,2501
GS_DUP_CNV_X_134530424_134540614,chrX,134530424,134540614,cases,10190
GS_DUP_CNV_2_133107651_133112519,chr2,133107651,133112519,control,4868
GS_DUP_CNV_2_133094613_133098917,chr2,133094613,133098917,control,4304
GS_DUP_CNV_12_133085766_133088065,chr12,133085766,133088065,control,2299
GS_DUP_CNV_2_133073955_133076404,chr2,133073955,133076404,control,2449
GS_DUP_CNV_2_133057010_133059561,chr2,133057010,133059561,control,2551
GS_DUP_CNV_2_133036042_133039759,chr2,133036042,133039759,control,3717
GS_DUP_CNV_2_133031109_133035054,chr2,133031109,133035054,control,3945
GS_DUP_CNV_2_133023606_133026773,chr2,133023606,133026773,control,3167
GS_DUP_CNV_4_132985575_133124800,chr4,132985575,133124800,control,139225
GS_DUP_CNV_4_132983425_133172993,chr4,132983425,133172993,control,189568
GS_DUP_CNV_9_132187681_132204286,chr9,132187681,132204286,control,16605
GS_DUP_CNV_9_132186781_132188880,chr9,132186781,132188880,control,2099
GS_DUP_CNV_12_131792703_131796758,chr12,131792703,131796758,control,4055
GS_DUP_CNV_2_130968993_130972042,chr2,130968993,130972042,control,3049
GS_DUP_CNV_9_130891952_130893996,chr9,130891952,130893996,control,2044
GS_DUP_CNV_11_130434597_130439571,chr11,130434597,130439571,control,4974
GS_DUP_CNV_10_128513172_128614233,chr10,128513172,128614233,control,101061
GS_DUP_CNV_X_125314944_125362273,chrX,125314944,125362273,control,47329
GS_DUP_CNV_12_124496225_124500124,chr12,124496225,124500124,control,3899
GS_DUP_CNV_8_122318964_122410380,chr8,122318964,122410380,control,91416
GS_DUP_CNV_5_119026311_119063330,chr5,119026311,119063330,control,37019
GS_DUP_CNV_X_118340355_118346191,chrX,118340355,118346191,control,5836
GS_DUP_CNV_9_117084387_117086578,chr9,117084387,117086578,control,2191
GS_DUP_CNV_4_115075790_115087301,chr4,115075790,115087301,control,11511
GS_DUP_CNV_11_114431224_114433323,chr11,114431224,114433323,control,2099
GS_DUP_CNV_11_114420892_114426044,chr11,114420892,114426044,control,5152
GS_DUP_CNV_11_114419942_114424894,chr11,114419942,114424894,control,4952
GS_DUP_CNV_13_113744960_113758590,chr13,113744960,113758590,control,13630
GS_DUP_CNV_2_113045382_113049131,chr2,113045382,113049131,control,3749
GS_DUP_CNV_X_112707039_112778567,chrX,112707039,112778567,control,71528
GS_DUP_CNV_X_112578795_112608568,chrX,112578795,112608568,control,29773
GS_DUP_CNV_2_112501539_112505611,chr2,112501539,112505611,control,4072
GS_DUP_CNV_2_112501539_112507904,chr2,112501539,112507904,control,6365
GS_DUP_CNV_2_112034880_112058475,chr2,112034880,112058475,control,23595
GS_DUP_CNV_1_106486731_106491536,chr1,106486731,106491536,control,4805
GS_DUP_CNV_1_106484593_106488079,chr1,106484593,106488079,control,3486
GS_DUP_CNV_1_104125670_104143949,chr1,104125670,104143949,control,18279
GS_DUP_CNV_1_104103047_104111107,chr1,104103047,104111107,cases,8060
GS_DUP_CNV_X_103261002_103267806,chrX,103261002,103267806,control,6804
GS_DUP_CNV_X_103257932_103261501,chrX,103257932,103261501,control,3569
GS_DUP_CNV_X_103257539_103263701,chrX,103257539,103263701,control,6162
GS_DUP_CNV_X_103171854_103231533,chrX,103171854,103231533,control,59679
GS_DUP_CNV_15_102129401_102156837,chr15,102129401,102156837,control,27436
GS_DUP_CNV_15_101935433_101991275,chr15,101935433,101991275,control,55842
GS_DUP_CNV_X_101833228_101842552,chrX,101833228,101842552,control,9324
GS_DUP_CNV_12_101546432_101550196,chr12,101546432,101550196,control,3764
GS_DUP_CNV_12_101545760_101550096,chr12,101545760,101550096,control,4336
GS_DUP_CNV_X_101053788_101057848,chrX,101053788,101057848,control,4060
GS_DUP_CNV_7_100936289_100938288,chr7,100936289,100938288,control,1999
GS_DUP_CNV_X_100793848_100804958,chrX,100793848,100804958,control,11110
GS_DUP_CNV_X_100746698_100761065,chrX,100746698,100761065,cases,14367
GS_DUP_CNV_7_100614416_100616815,chr7,100614416,100616815,control,2399
GS_DUP_CNV_7_100606089_100613269,chr7,100606089,100613269,control,7180
GS_DUP_CNV_7_100606089_100619235,chr7,100606089,100619235,control,13146
GS_DUP_CNV_7_100551812_100555107,chr7,100551812,100555107,control,3295
GS_DUP_CNV_7_100546239_100548288,chr7,100546239,100548288,control,2049
GS_DUP_CNV_5_98522763_99321682,chr5,98522763,99321682,control,798919
GS_DUP_CNV_2_97888023_97897933,chr2,97888023,97897933,control,9910
GS_DUP_CNV_2_97817592_97820699,chr2,97817592,97820699,control,3107
GS_DUP_CNV_12_97363076_97365375,chr12,97363076,97365375,control,2299
GS_DUP_CNV_10_96911729_96914736,chr10,96911729,96914736,control,3007
GS_DUP_CNV_10_96911729_96915885,chr10,96911729,96915885,control,4156
GS_DUP_CNV_2_96727240_96734400,chr2,96727240,96734400,control,7160
GS_DUP_CNV_2_96726273_96729594,chr2,96726273,96729594,control,3321
GS_DUP_CNV_2_96618328_96620997,chr2,96618328,96620997,control,2669
GS_DUP_CNV_3_96531748_96533777,chr3,96531748,96533777,control,2029
GS_DUP_CNV_10_95544948_95547236,chr10,95544948,95547236,control,2288
GS_DUP_CNV_15_94886119_94888492,chr15,94886119,94888492,control,2373
GS_DUP_CNV_X_94234911_94297558,chrX,94234911,94297558,control,62647
GS_DUP_CNV_11_94086047_94088125,chr11,94086047,94088125,control,2078
GS_DUP_CNV_11_94083400_94086805,chr11,94083400,94086805,control,3405
GS_DUP_CNV_2_92262156_92268950,chr2,92262156,92268950,control,6794
GS_DUP_CNV_2_92060853_92200496,chr2,92060853,92200496,control,139643
GS_DUP_CNV_2_92047995_92050831,chr2,92047995,92050831,control,2836
GS_DUP_CNV_2_91967953_91971784,chr2,91967953,91971784,control,3831
GS_DUP_CNV_2_91959325_91979990,chr2,91959325,91979990,control,20665
GS_DUP_CNV_2_91927541_92160114,chr2,91927541,92160114,control,232573
GS_DUP_CNV_2_91922389_91924394,chr2,91922389,91924394,control,2005
GS_DUP_CNV_2_91873825_91877820,chr2,91873825,91877820,control,3995
GS_DUP_CNV_2_91870385_91874595,chr2,91870385,91874595,control,4210
GS_DUP_CNV_2_91868249_91871534,chr2,91868249,91871534,control,3285
GS_DUP_CNV_2_91862042_91866888,chr2,91862042,91866888,control,4846
GS_DUP_CNV_2_91849043_91858269,chr2,91849043,91858269,control,9226
GS_DUP_CNV_2_91836915_91840152,chr2,91836915,91840152,control,3237
GS_DUP_CNV_2_91836479_91851278,chr2,91836479,91851278,control,14799
GS_DUP_CNV_2_91829844_91834977,chr2,91829844,91834977,control,5133
GS_DUP_CNV_2_91822819_91835146,chr2,91822819,91835146,control,12327
GS_DUP_CNV_2_91806756_91814515,chr2,91806756,91814515,control,7759
GS_DUP_CNV_2_91789317_91795447,chr2,91789317,91795447,control,6130
GS_DUP_CNV_2_91768021_91772558,chr2,91768021,91772558,control,4537
GS_DUP_CNV_2_91760117_91765393,chr2,91760117,91765393,control,5276
GS_DUP_CNV_2_91751880_91759416,chr2,91751880,91759416,control,7536
GS_DUP_CNV_5_88908487_88918412,chr5,88908487,88918412,control,9925
GS_DUP_CNV_16_88564741_88567940,chr16,88564741,88567940,control,3199
GS_DUP_CNV_16_88172438_88175002,chr16,88172438,88175002,control,2564
GS_DUP_CNV_16_88164438_88166837,chr16,88164438,88166837,control,2399
GS_DUP_CNV_2_87540334_87568231,chr2,87540334,87568231,control,27897
GS_DUP_CNV_2_87526438_87533774,chr2,87526438,87533774,control,7336
GS_DUP_CNV_2_87510340_87513764,chr2,87510340,87513764,control,3424
GS_DUP_CNV_2_87488708_87491949,chr2,87488708,87491949,control,3241
GS_DUP_CNV_2_87475049_87478391,chr2,87475049,87478391,control,3342
GS_DUP_CNV_9_87447257_90751199,chr9,87447257,90751199,control,3303942
GS_DUP_CNV_2_87370744_87377211,chr2,87370744,87377211,control,6467
GS_DUP_CNV_2_87370518_87372802,chr2,87370518,87372802,control,2284
GS_DUP_CNV_9_86644744_90782968,chr9,86644744,90782968,control,4138224
GS_DUP_CNV_1_85984880_85987718,chr1,85984880,85987718,control,2838
GS_DUP_CNV_1_85980180_85993039,chr1,85980180,85993039,control,12859
GS_DUP_CNV_8_85929215_85932129,chr8,85929215,85932129,control,2914
GS_DUP_CNV_16_85106183_85310557,chr16,85106183,85310557,control,204374
GS_DUP_CNV_15_85073699_85095321,chr15,85073699,85095321,control,21622
GS_DUP_CNV_13_84074798_84151817,chr13,84074798,84151817,control,77019
GS_DUP_CNV_5_81422962_81430541,chr5,81422962,81430541,control,7579
GS_DUP_CNV_10_81294612_81316447,chr10,81294612,81316447,control,21835
GS_DUP_CNV_10_81281027_81283376,chr10,81281027,81283376,control,2349
GS_DUP_CNV_10_81279899_81283376,chr10,81279899,81283376,control,3477
GS_DUP_CNV_2_79329465_79335461,chr2,79329465,79335461,control,5996
GS_DUP_CNV_4_78275609_78281019,chr4,78275609,78281019,control,5410
GS_DUP_CNV_18_78011105_78015758,chr18,78011105,78015758,control,4653
GS_DUP_CNV_3_77826246_77831689,chr3,77826246,77831689,control,5443
GS_DUP_CNV_18_77111834_77116833,chr18,77111834,77116833,control,4999
GS_DUP_CNV_7_76607655_76611968,chr7,76607655,76611968,control,4313
GS_DUP_CNV_7_76607118_76610237,chr7,76607118,76610237,cases,3119
GS_DUP_CNV_7_76560054_76569466,chr7,76560054,76569466,control,9412
GS_DUP_CNV_7_76557558_76562518,chr7,76557558,76562518,control,4960
GS_DUP_CNV_7_76547083_76550786,chr7,76547083,76550786,control,3703
GS_DUP_CNV_7_76545161_76561856,chr7,76545161,76561856,control,16695
GS_DUP_CNV_7_76527889_76534558,chr7,76527889,76534558,control,6669
GS_DUP_CNV_7_76515707_76523849,chr7,76515707,76523849,control,8142
GS_DUP_CNV_7_76500525_76507215,chr7,76500525,76507215,control,6690
GS_DUP_CNV_7_76492014_76503895,chr7,76492014,76503895,control,11881
GS_DUP_CNV_7_76489132_76491400,chr7,76489132,76491400,control,2268
GS_DUP_CNV_7_76489132_76503895,chr7,76489132,76503895,control,14763
GS_DUP_CNV_7_76468284_76470361,chr7,76468284,76470361,control,2077
GS_DUP_CNV_7_76463739_76467279,chr7,76463739,76467279,control,3540
GS_DUP_CNV_7_76462652_76472449,chr7,76462652,76472449,control,9797
GS_DUP_CNV_7_76452648_76464985,chr7,76452648,76464985,control,12337
GS_DUP_CNV_7_76451231_76458956,chr7,76451231,76458956,control,7725
GS_DUP_CNV_7_76444211_76446910,chr7,76444211,76446910,control,2699
GS_DUP_CNV_7_76439744_76441747,chr7,76439744,76441747,control,2003
GS_DUP_CNV_7_76438319_76443816,chr7,76438319,76443816,control,5497
GS_DUP_CNV_7_76430174_76443343,chr7,76430174,76443343,cases,13169
GS_DUP_CNV_7_76317644_76361019,chr7,76317644,76361019,control,43375
GS_DUP_CNV_7_76294128_76305982,chr7,76294128,76305982,control,11854
GS_DUP_CNV_13_76116775_76120474,chr13,76116775,76120474,control,3699
GS_DUP_CNV_3_75270148_75277479,chr3,75270148,75277479,control,7331
GS_DUP_CNV_X_75211583_75224933,chrX,75211583,75224933,control,13350
GS_DUP_CNV_16_74456626_74459876,chr16,74456626,74459876,control,3250
GS_DUP_CNV_16_74455110_74460766,chr16,74455110,74460766,cases,5656
GS_DUP_CNV_16_74429194_74433254,chr16,74429194,74433254,control,4060
GS_DUP_CNV_16_74406122_74409209,chr16,74406122,74409209,control,3087
GS_DUP_CNV_16_74400416_74406921,chr16,74400416,74406921,cases,6505
GS_DUP_CNV_15_74395008_74449264,chr15,74395008,74449264,control,54256
GS_DUP_CNV_16_74394726_74397695,chr16,74394726,74397695,cases,2969
GS_DUP_CNV_X_74331665_74336521,chrX,74331665,74336521,control,4856
GS_DUP_CNV_X_74328330_74335821,chrX,74328330,74335821,control,7491
GS_DUP_CNV_9_73905814_73910613,chr9,73905814,73910613,control,4799
GS_DUP_CNV_X_73534593_73537243,chrX,73534593,73537243,control,2650
GS_DUP_CNV_4_72671572_72674911,chr4,72671572,72674911,control,3339
GS_DUP_CNV_9_72024798_72057117,chr9,72024798,72057117,control,32319
GS_DUP_CNV_16_70977703_70980402,chr16,70977703,70980402,control,2699
GS_DUP_CNV_6_70208624_70225533,chr6,70208624,70225533,control,16909
GS_DUP_CNV_16_70188133_70199773,chr16,70188133,70199773,cases,11640
GS_DUP_CNV_16_70184325_70188532,chr16,70184325,70188532,control,4207
GS_DUP_CNV_16_70177168_70183653,chr16,70177168,70183653,cases,6485
GS_DUP_CNV_16_70172229_70175677,chr16,70172229,70175677,cases,3448
GS_DUP_CNV_16_70169384_70171611,chr16,70169384,70171611,control,2227
GS_DUP_CNV_16_70160527_70167171,chr16,70160527,70167171,control,6644
GS_DUP_CNV_16_70157385_70161732,chr16,70157385,70161732,control,4347
GS_DUP_CNV_16_70156106_70158971,chr16,70156106,70158971,control,2865
GS_DUP_CNV_16_70155487_70158883,chr16,70155487,70158883,cases,3396
GS_DUP_CNV_9_69840161_69851904,chr9,69840161,69851904,cases,11743
GS_DUP_CNV_9_69837498_69839626,chr9,69837498,69839626,control,2128
GS_DUP_CNV_9_69835400_69842399,chr9,69835400,69842399,cases,6999
GS_DUP_CNV_9_69832023_69837001,chr9,69832023,69837001,control,4978
GS_DUP_CNV_9_69827841_69832176,chr9,69827841,69832176,control,4335
GS_DUP_CNV_9_69827741_69830425,chr9,69827741,69830425,control,2684
GS_DUP_CNV_9_69825131_69829127,chr9,69825131,69829127,cases,3996
GS_DUP_CNV_9_69809558_69811983,chr9,69809558,69811983,cases,2425
GS_DUP_CNV_9_69804939_69807803,chr9,69804939,69807803,cases,2864
GS_DUP_CNV_9_69804768_69811683,chr9,69804768,69811683,control,6915
GS_DUP_CNV_X_69461916_69470520,chrX,69461916,69470520,control,8604
GS_DUP_CNV_6_69229826_69241785,chr6,69229826,69241785,control,11959
GS_DUP_CNV_9_68990054_68992498,chr9,68990054,68992498,control,2444
GS_DUP_CNV_9_68989619_68991741,chr9,68989619,68991741,control,2122
GS_DUP_CNV_9_68379787_68383069,chr9,68379787,68383069,control,3282
GS_DUP_CNV_9_67335834_67339998,chr9,67335834,67339998,control,4164
GS_DUP_CNV_9_67331891_67336156,chr9,67331891,67336156,control,4265
GS_DUP_CNV_9_67328690_67336702,chr9,67328690,67336702,control,8012
GS_DUP_CNV_9_66830991_66839512,chr9,66830991,66839512,control,8521
GS_DUP_CNV_9_66826636_66831598,chr9,66826636,66831598,control,4962
GS_DUP_CNV_9_66534680_66537391,chr9,66534680,66537391,control,2711
GS_DUP_CNV_9_66526359_66528421,chr9,66526359,66528421,control,2062
GS_DUP_CNV_9_66516337_66522285,chr9,66516337,66522285,control,5948
GS_DUP_CNV_9_66514391_66516988,chr9,66514391,66516988,control,2597
GS_DUP_CNV_7_65275963_65278995,chr7,65275963,65278995,control,3032
GS_DUP_CNV_7_65259671_65287767,chr7,65259671,65287767,control,28096
GS_DUP_CNV_13_64346184_64348283,chr13,64346184,64348283,control,2099
GS_DUP_CNV_13_64339609_64385428,chr13,64339609,64385428,control,45819
GS_DUP_CNV_12_63939118_64129986,chr12,63939118,64129986,control,190868
GS_DUP_CNV_13_63644723_63649443,chr13,63644723,63649443,control,4720
GS_DUP_CNV_18_63198932_63201558,chr18,63198932,63201558,control,2626
GS_DUP_CNV_11_63191433_63198100,chr11,63191433,63198100,control,6667
GS_DUP_CNV_11_63187958_63192966,chr11,63187958,63192966,control,5008
GS_DUP_CNV_7_63037709_63040972,chr7,63037709,63040972,control,3263
GS_DUP_CNV_7_63035668_63039002,chr7,63035668,63039002,control,3334
GS_DUP_CNV_7_63032040_63035002,chr7,63032040,63035002,control,2962
GS_DUP_CNV_7_63030821_63034504,chr7,63030821,63034504,control,3683
GS_DUP_CNV_7_63026573_63034504,chr7,63026573,63034504,control,7931
GS_DUP_CNV_7_62983626_62985857,chr7,62983626,62985857,control,2231
GS_DUP_CNV_7_62979803_62985085,chr7,62979803,62985085,control,5282
GS_DUP_CNV_X_62477400_62509634,chrX,62477400,62509634,control,32234
GS_DUP_CNV_7_62474100_62476349,chr7,62474100,62476349,control,2249
GS_DUP_CNV_7_62468558_62476349,chr7,62468558,62476349,control,7791
GS_DUP_CNV_7_61898463_61902003,chr7,61898463,61902003,control,3540
GS_DUP_CNV_8_60135907_60138341,chr8,60135907,60138341,control,2434
GS_DUP_CNV_8_60133907_60136606,chr8,60133907,60136606,control,2699
GS_DUP_CNV_20_59903171_59905299,chr20,59903171,59905299,control,2128
GS_DUP_CNV_20_59621107_59623206,chr20,59621107,59623206,control,2099
GS_DUP_CNV_20_59618747_59621606,chr20,59618747,59621606,control,2859
GS_DUP_CNV_6_58145037_58148647,chr6,58145037,58148647,control,3610
GS_DUP_CNV_X_57750608_57754377,chrX,57750608,57754377,control,3769
GS_DUP_CNV_7_57746287_57748310,chr7,57746287,57748310,control,2023
GS_DUP_CNV_X_57745155_57752538,chrX,57745155,57752538,control,7383
GS_DUP_CNV_7_57702666_57705589,chr7,57702666,57705589,control,2923
GS_DUP_CNV_6_57603885_57609134,chr6,57603885,57609134,control,5249
GS_DUP_CNV_6_57602235_57605334,chr6,57602235,57605334,control,3099
GS_DUP_CNV_6_57594528_57601411,chr6,57594528,57601411,control,6883
GS_DUP_CNV_6_57591628_57598012,chr6,57591628,57598012,control,6384
GS_DUP_CNV_6_57588890_57592927,chr6,57588890,57592927,control,4037
GS_DUP_CNV_6_57580572_57587753,chr6,57580572,57587753,control,7181
GS_DUP_CNV_6_57577622_57580646,chr6,57577622,57580646,control,3024
GS_DUP_CNV_6_57575722_57583071,chr6,57575722,57583071,control,7349
GS_DUP_CNV_6_57572987_57575021,chr6,57572987,57575021,control,2034
GS_DUP_CNV_6_57566647_57568946,chr6,57566647,57568946,control,2299
GS_DUP_CNV_6_57562194_57565493,chr6,57562194,57565493,control,3299
GS_DUP_CNV_6_57557464_57560563,chr6,57557464,57560563,control,3099
GS_DUP_CNV_6_57545856_57550098,chr6,57545856,57550098,control,4242
GS_DUP_CNV_6_57535509_57542953,chr6,57535509,57542953,control,7444
GS_DUP_CNV_6_57527964_57532700,chr6,57527964,57532700,control,4736
GS_DUP_CNV_6_57526064_57531700,chr6,57526064,57531700,control,5636
GS_DUP_CNV_6_57517709_57523513,chr6,57517709,57523513,control,5804
GS_DUP_CNV_6_57511984_57523238,chr6,57511984,57523238,control,11254
GS_DUP_CNV_6_57508957_57511280,chr6,57508957,57511280,control,2323
GS_DUP_CNV_6_57505489_57508756,chr6,57505489,57508756,control,3267
GS_DUP_CNV_6_57496573_57508756,chr6,57496573,57508756,control,12183
GS_DUP_CNV_6_57488183_57493297,chr6,57488183,57493297,control,5114
GS_DUP_CNV_6_57488008_57491422,chr6,57488008,57491422,control,3414
GS_DUP_CNV_6_57484283_57487382,chr6,57484283,57487382,control,3099
GS_DUP_CNV_6_57482883_57484982,chr6,57482883,57484982,control,2099
GS_DUP_CNV_6_57475770_57479169,chr6,57475770,57479169,control,3399
GS_DUP_CNV_6_57473670_57475969,chr6,57473670,57475969,control,2299
GS_DUP_CNV_6_57469470_57477419,chr6,57469470,57477419,control,7949
GS_DUP_CNV_6_57465308_57469719,chr6,57465308,57469719,control,4411
GS_DUP_CNV_6_57462008_57466007,chr6,57462008,57466007,control,3999
GS_DUP_CNV_6_57459708_57462307,chr6,57459708,57462307,control,2599
GS_DUP_CNV_6_57455608_57458607,chr6,57455608,57458607,control,2999
GS_DUP_CNV_6_57453758_57456507,chr6,57453758,57456507,control,2749
GS_DUP_CNV_6_57433664_57442825,chr6,57433664,57442825,control,9161
GS_DUP_CNV_6_57429817_57432066,chr6,57429817,57432066,control,2249
GS_DUP_CNV_6_57409787_57418034,chr6,57409787,57418034,control,8247
GS_DUP_CNV_6_57402925_57405459,chr6,57402925,57405459,control,2534
GS_DUP_CNV_6_57398789_57402274,chr6,57398789,57402274,control,3485
GS_DUP_CNV_6_57386065_57400063,chr6,57386065,57400063,control,13998
GS_DUP_CNV_6_57381827_57384814,chr6,57381827,57384814,control,2987
GS_DUP_CNV_6_57375677_57384914,chr6,57375677,57384914,control,9237
GS_DUP_CNV_6_57337289_57342590,chr6,57337289,57342590,control,5301
GS_DUP_CNV_6_57317725_57328828,chr6,57317725,57328828,control,11103
GS_DUP_CNV_6_57252664_57632044,chr6,57252664,57632044,control,379380
GS_DUP_CNV_6_57240772_57242870,chr6,57240772,57242870,control,2098
GS_DUP_CNV_6_57233210_57235309,chr6,57233210,57235309,control,2099
GS_DUP_CNV_6_57196074_57232259,chr6,57196074,57232259,control,36185
GS_DUP_CNV_7_56557926_56561351,chr7,56557926,56561351,control,3425
GS_DUP_CNV_7_56557397_56564151,chr7,56557397,56564151,control,6754
GS_DUP_CNV_11_56465636_56472226,chr11,56465636,56472226,control,6590
GS_DUP_CNV_2_56020850_56038650,chr2,56020850,56038650,control,17800
GS_DUP_CNV_12_55894669_55913691,chr12,55894669,55913691,control,19022
GS_DUP_CNV_16_55857535_55862405,chr16,55857535,55862405,control,4870
GS_DUP_CNV_7_55810642_55812671,chr7,55810642,55812671,control,2029
GS_DUP_CNV_7_55809600_55812171,chr7,55809600,55812171,control,2571
GS_DUP_CNV_12_55782259_55784358,chr12,55782259,55784358,control,2099
GS_DUP_CNV_11_55635892_55648941,chr11,55635892,55648941,control,13049
GS_DUP_CNV_11_55459254_56009732,chr11,55459254,56009732,control,550478
GS_DUP_CNV_11_55359171_55364613,chr11,55359171,55364613,control,5442
GS_DUP_CNV_11_55354239_55364613,chr11,55354239,55364613,control,10374
GS_DUP_CNV_11_55347256_55362288,chr11,55347256,55362288,control,15032
GS_DUP_CNV_11_55118925_55120924,chr11,55118925,55120924,control,1999
GS_DUP_CNV_11_55117875_55121124,chr11,55117875,55121124,control,3249
GS_DUP_CNV_11_55109456_55112155,chr11,55109456,55112155,control,2699
GS_DUP_CNV_11_55109456_55113324,chr11,55109456,55113324,control,3868
GS_DUP_CNV_11_55103453_55434455,chr11,55103453,55434455,control,331002
GS_DUP_CNV_19_53550517_53553729,chr19,53550517,53553729,control,3212
GS_DUP_CNV_19_53546192_53551266,chr19,53546192,53551266,control,5074
GS_DUP_CNV_19_53534542_53536902,chr19,53534542,53536902,control,2360
GS_DUP_CNV_19_53530883_53534291,chr19,53530883,53534291,cases,3408
GS_DUP_CNV_13_52908030_52911035,chr13,52908030,52911035,control,3005
GS_DUP_CNV_13_52895610_52901016,chr13,52895610,52901016,control,5406
GS_DUP_CNV_13_52885575_52891010,chr13,52885575,52891010,control,5435
GS_DUP_CNV_13_52882276_52887064,chr13,52882276,52887064,control,4788
GS_DUP_CNV_13_52874036_52876387,chr13,52874036,52876387,control,2351
GS_DUP_CNV_13_52863449_52876387,chr13,52863449,52876387,control,12938
GS_DUP_CNV_13_52861247_52863448,chr13,52861247,52863448,control,2201
GS_DUP_CNV_13_52857165_52863010,chr13,52857165,52863010,control,5845
GS_DUP_CNV_13_52852408_52857164,chr13,52852408,52857164,control,4756
GS_DUP_CNV_13_52852028_52859528,chr13,52852028,52859528,control,7500
GS_DUP_CNV_X_52658969_52675046,chrX,52658969,52675046,control,16077
GS_DUP_CNV_20_52476316_52482172,chr20,52476316,52482172,control,5856
GS_DUP_CNV_10_51775062_51783179,chr10,51775062,51783179,control,8117
GS_DUP_CNV_11_51454358_51494275,chr11,51454358,51494275,control,39917
GS_DUP_CNV_22_51068449_51075153,chr22,51068449,51075153,control,6704
GS_DUP_CNV_11_48361087_48364109,chr11,48361087,48364109,control,3022
GS_DUP_CNV_10_48356986_48359985,chr10,48356986,48359985,control,2999
GS_DUP_CNV_11_48356937_48363509,chr11,48356937,48363509,control,6572
GS_DUP_CNV_11_48356837_48359536,chr11,48356837,48359536,control,2699
GS_DUP_CNV_X_47878960_47882646,chrX,47878960,47882646,cases,3686
GS_DUP_CNV_10_47683657_47690771,chr10,47683657,47690771,control,7114
GS_DUP_CNV_10_47679885_47683028,chr10,47679885,47683028,control,3143
GS_DUP_CNV_10_47651746_47679194,chr10,47651746,47679194,control,27448
GS_DUP_CNV_10_47140309_47151357,chr10,47140309,47151357,cases,11048
GS_DUP_CNV_10_47058236_47123411,chr10,47058236,47123411,control,65175
GS_DUP_CNV_10_47024194_47048846,chr10,47024194,47048846,control,24652
GS_DUP_CNV_10_47018311_47020510,chr10,47018311,47020510,control,2199
GS_DUP_CNV_10_47001495_47019410,chr10,47001495,47019410,control,17915
GS_DUP_CNV_10_46987790_46998469,chr10,46987790,46998469,control,10679
GS_DUP_CNV_10_46976400_46987889,chr10,46976400,46987889,control,11489
GS_DUP_CNV_10_46966242_46976599,chr10,46966242,46976599,control,10357
GS_DUP_CNV_10_46962803_46969148,chr10,46962803,46969148,cases,6345
GS_DUP_CNV_10_46952579_46962386,chr10,46952579,46962386,control,9807
GS_DUP_CNV_10_46946623_46949570,chr10,46946623,46949570,cases,2947
GS_DUP_CNV_21_46473034_46475133,chr21,46473034,46475133,control,2099
GS_DUP_CNV_10_46219199_46222483,chr10,46219199,46222483,control,3284
GS_DUP_CNV_15_45322983_45325565,chr15,45322983,45325565,control,2582
GS_DUP_CNV_2_45307594_45322967,chr2,45307594,45322967,control,15373
GS_DUP_CNV_15_45260811_45280107,chr15,45260811,45280107,control,19296
GS_DUP_CNV_9_44794256_44797357,chr9,44794256,44797357,control,3101
GS_DUP_CNV_9_44791505_44804366,chr9,44791505,44804366,control,12861
GS_DUP_CNV_17_44328650_44332092,chr17,44328650,44332092,cases,3442
GS_DUP_CNV_17_44307529_44310159,chr17,44307529,44310159,control,2630
GS_DUP_CNV_17_44265163_44268084,chr17,44265163,44268084,control,2921
GS_DUP_CNV_17_44233275_44236797,chr17,44233275,44236797,cases,3522
GS_DUP_CNV_17_44232275_44235297,chr17,44232275,44235297,control,3022
GS_DUP_CNV_17_44222519_44224714,chr17,44222519,44224714,cases,2195
GS_DUP_CNV_17_44212296_44214895,chr17,44212296,44214895,cases,2599
GS_DUP_CNV_17_44208595_44212395,chr17,44208595,44212395,control,3800
GS_DUP_CNV_17_44203945_44212345,chr17,44203945,44212345,cases,8400
GS_DUP_CNV_17_44190197_44205406,chr17,44190197,44205406,control,15209
GS_DUP_CNV_17_44171274_44186585,chr17,44171274,44186585,cases,15311
GS_DUP_CNV_17_44166099_44169446,chr17,44166099,44169446,cases,3347
GS_DUP_CNV_17_44164952_44167198,chr17,44164952,44167198,cases,2246
GS_DUP_CNV_9_43858076_43864131,chr9,43858076,43864131,cases,6055
GS_DUP_CNV_17_43686406_43691548,chr17,43686406,43691548,control,5142
GS_DUP_CNV_17_43685596_43689497,chr17,43685596,43689497,control,3901
GS_DUP_CNV_17_43656845_43662407,chr17,43656845,43662407,control,5562
GS_DUP_CNV_17_43654845_43659503,chr17,43654845,43659503,control,4658
GS_DUP_CNV_17_43650454_43655744,chr17,43650454,43655744,control,5290
GS_DUP_CNV_19_43231810_43244464,chr19,43231810,43244464,control,12654
GS_DUP_CNV_10_43200583_43234374,chr10,43200583,43234374,control,33791
GS_DUP_CNV_10_43026890_43033491,chr10,43026890,43033491,control,6601
GS_DUP_CNV_11_42967604_42973442,chr11,42967604,42973442,control,5838
GS_DUP_CNV_12_42035437_42059391,chr12,42035437,42059391,control,23954
GS_DUP_CNV_9_40753406_40755691,chr9,40753406,40755691,control,2285
GS_DUP_CNV_9_40618945_40627410,chr9,40618945,40627410,control,8465
GS_DUP_CNV_15_39194946_39248859,chr15,39194946,39248859,control,53913
GS_DUP_CNV_9_39037494_39042888,chr9,39037494,39042888,control,5394
GS_DUP_CNV_9_39015649_39022855,chr9,39015649,39022855,control,7206
GS_DUP_CNV_9_39008454_39012394,chr9,39008454,39012394,control,3940
GS_DUP_CNV_X_38588320_38612986,chrX,38588320,38612986,control,24666
GS_DUP_CNV_10_38565513_38570957,chr10,38565513,38570957,control,5444
GS_DUP_CNV_10_38563494_38567152,chr10,38563494,38567152,control,3658
GS_DUP_CNV_10_38560828_38564609,chr10,38560828,38564609,control,3781
GS_DUP_CNV_10_38559893_38562363,chr10,38559893,38562363,control,2470
GS_DUP_CNV_12_38447866_38450520,chr12,38447866,38450520,control,2654
GS_DUP_CNV_2_37978105_38004287,chr2,37978105,38004287,control,26182
GS_DUP_CNV_2_37956847_37983004,chr2,37956847,37983004,control,26157
GS_DUP_CNV_X_37374545_37382265,chrX,37374545,37382265,control,7720
GS_DUP_CNV_X_37353313_37363119,chrX,37353313,37363119,control,9806
GS_DUP_CNV_17_36397059_36399904,chr17,36397059,36399904,control,2845
GS_DUP_CNV_17_36388636_36391561,chr17,36388636,36391561,control,2925
GS_DUP_CNV_17_36381641_36384140,chr17,36381641,36384140,control,2499
GS_DUP_CNV_17_36381641_36386130,chr17,36381641,36386130,control,4489
GS_DUP_CNV_17_36373165_36377795,chr17,36373165,36377795,control,4630
GS_DUP_CNV_17_36362923_36371456,chr17,36362923,36371456,control,8533
GS_DUP_CNV_17_36354302_36359277,chr17,36354302,36359277,control,4975
GS_DUP_CNV_17_36299380_36305962,chr17,36299380,36305962,control,6582
GS_DUP_CNV_17_36299280_36303896,chr17,36299280,36303896,control,4616
GS_DUP_CNV_17_36296703_36301294,chr17,36296703,36301294,control,4591
GS_DUP_CNV_18_34844313_34847286,chr18,34844313,34847286,control,2973
GS_DUP_CNV_16_34737095_34740994,chr16,34737095,34740994,control,3899
GS_DUP_CNV_16_34698578_34704097,chr16,34698578,34704097,control,5519
GS_DUP_CNV_16_34692379_34719832,chr16,34692379,34719832,control,27453
GS_DUP_CNV_16_34689529_34693978,chr16,34689529,34693978,control,4449
GS_DUP_CNV_16_34628995_34648168,chr16,34628995,34648168,control,19173
GS_DUP_CNV_16_34565266_34568465,chr16,34565266,34568465,control,3199
GS_DUP_CNV_16_34558567_34561755,chr16,34558567,34561755,control,3188
GS_DUP_CNV_16_34547318_34551417,chr16,34547318,34551417,control,4099
GS_DUP_CNV_16_34546118_34548117,chr16,34546118,34548117,control,1999
GS_DUP_CNV_16_34510215_34563515,chr16,34510215,34563515,control,53300
GS_DUP_CNV_16_34507115_34512494,chr16,34507115,34512494,control,5379
GS_DUP_CNV_16_34477731_34481348,chr16,34477731,34481348,control,3617
GS_DUP_CNV_16_34470360_34483746,chr16,34470360,34483746,control,13386
GS_DUP_CNV_16_34464673_34469059,chr16,34464673,34469059,control,4386
GS_DUP_CNV_16_33580317_33585239,chr16,33580317,33585239,control,4922
GS_DUP_CNV_16_33579978_33583647,chr16,33579978,33583647,control,3669
GS_DUP_CNV_16_33575503_33581510,chr16,33575503,33581510,control,6007
GS_DUP_CNV_16_33574316_33581510,chr16,33574316,33581510,control,7194
GS_DUP_CNV_16_33522214_33529832,chr16,33522214,33529832,control,7618
GS_DUP_CNV_16_33504352_33507302,chr16,33504352,33507302,control,2950
GS_DUP_CNV_16_32647490_32659897,chr16,32647490,32659897,control,12407
GS_DUP_CNV_16_32641738_32645089,chr16,32641738,32645089,control,3351
GS_DUP_CNV_16_32640138_32643359,chr16,32640138,32643359,control,3221
GS_DUP_CNV_16_32618123_32642237,chr16,32618123,32642237,control,24114
GS_DUP_CNV_16_32609979_32624597,chr16,32609979,32624597,control,14618
GS_DUP_CNV_16_32608479_32612195,chr16,32608479,32612195,control,3716
GS_DUP_CNV_16_32485803_32488030,chr16,32485803,32488030,control,2227
GS_DUP_CNV_16_32480300_32486052,chr16,32480300,32486052,control,5752
GS_DUP_CNV_16_32470195_32479043,chr16,32470195,32479043,control,8848
GS_DUP_CNV_16_32469758_32486302,chr16,32469758,32486302,control,16544
GS_DUP_CNV_16_32468106_32479243,chr16,32468106,32479243,control,11137
GS_DUP_CNV_16_32463821_32467763,chr16,32463821,32467763,control,3942
GS_DUP_CNV_16_32460582_32465332,chr16,32460582,32465332,control,4750
GS_DUP_CNV_6_32450257_32452656,chr6,32450257,32452656,control,2399
GS_DUP_CNV_16_32449640_32454517,chr16,32449640,32454517,control,4877
GS_DUP_CNV_16_32446128_32451927,chr16,32446128,32451927,control,5799
GS_DUP_CNV_16_32443268_32452127,chr16,32443268,32452127,control,8859
GS_DUP_CNV_16_32435039_32439029,chr16,32435039,32439029,control,3990
GS_DUP_CNV_16_32419001_32421496,chr16,32419001,32421496,control,2495
GS_DUP_CNV_16_32400116_32408452,chr16,32400116,32408452,control,8336
GS_DUP_CNV_16_32394588_32398119,chr16,32394588,32398119,control,3531
GS_DUP_CNV_16_32392603_32396526,chr16,32392603,32396526,control,3923
GS_DUP_CNV_16_32390221_32394087,chr16,32390221,32394087,control,3866
GS_DUP_CNV_16_32386066_32391556,chr16,32386066,32391556,control,5490
GS_DUP_CNV_16_32384582_32389810,chr16,32384582,32389810,control,5228
GS_DUP_CNV_16_32370303_32379288,chr16,32370303,32379288,control,8985
GS_DUP_CNV_16_32365268_32369466,chr16,32365268,32369466,control,4198
GS_DUP_CNV_16_32363158_32369466,chr16,32363158,32369466,control,6308
GS_DUP_CNV_16_32356189_32364013,chr16,32356189,32364013,control,7824
GS_DUP_CNV_16_32354038_32362914,chr16,32354038,32362914,control,8876
GS_DUP_CNV_16_32353577_32358064,chr16,32353577,32358064,control,4487
GS_DUP_CNV_16_32329015_32331730,chr16,32329015,32331730,control,2715
GS_DUP_CNV_16_32177611_32183096,chr16,32177611,32183096,control,5485
GS_DUP_CNV_16_32177561_32180220,chr16,32177561,32180220,control,2659
GS_DUP_CNV_16_32014855_32040002,chr16,32014855,32040002,control,25147
GS_DUP_CNV_15_32010319_32426115,chr15,32010319,32426115,control,415796
GS_DUP_CNV_15_32006367_32017181,chr15,32006367,32017181,control,10814
GS_DUP_CNV_6_32004642_32008199,chr6,32004642,32008199,control,3557
GS_DUP_CNV_12_31273743_31288034,chr12,31273743,31288034,control,14291
GS_DUP_CNV_12_31265926_31271349,chr12,31265926,31271349,control,5423
GS_DUP_CNV_9_30963715_31053296,chr9,30963715,31053296,control,89581
GS_DUP_CNV_7_29786377_29788736,chr7,29786377,29788736,cases,2359
GS_DUP_CNV_7_29785277_29788736,chr7,29785277,29788736,control,3459
GS_DUP_CNV_7_29780137_29790536,chr7,29780137,29790536,control,10399
GS_DUP_CNV_7_29690293_29748094,chr7,29690293,29748094,control,57801
GS_DUP_CNV_20_29572881_29576681,chr20,29572881,29576681,control,3800
GS_DUP_CNV_20_29520574_29545239,chr20,29520574,29545239,control,24665
GS_DUP_CNV_20_29487539_29490299,chr20,29487539,29490299,control,2760
GS_DUP_CNV_20_29483810_29491911,chr20,29483810,29491911,control,8101
GS_DUP_CNV_20_29459935_29463230,chr20,29459935,29463230,control,3295
GS_DUP_CNV_20_29455856_29460612,chr20,29455856,29460612,control,4756
GS_DUP_CNV_20_29447151_29451669,chr20,29447151,29451669,control,4518
GS_DUP_CNV_20_29444115_29446950,chr20,29444115,29446950,control,2835
GS_DUP_CNV_20_29435955_29440144,chr20,29435955,29440144,control,4189
GS_DUP_CNV_20_29434741_29444439,chr20,29434741,29444439,control,9698
GS_DUP_CNV_16_29423746_29431717,chr16,29423746,29431717,control,7971
GS_DUP_CNV_20_29422817_29427415,chr20,29422817,29427415,control,4598
GS_DUP_CNV_20_29419615_29422216,chr20,29419615,29422216,control,2601
GS_DUP_CNV_15_28940113_28942990,chr15,28940113,28942990,control,2877
GS_DUP_CNV_15_28939594_28942685,chr15,28939594,28942685,control,3091
GS_DUP_CNV_15_28702749_28709500,chr15,28702749,28709500,control,6751
GS_DUP_CNV_15_28559895_28564412,chr15,28559895,28564412,control,4517
GS_DUP_CNV_15_28548312_28556133,chr15,28548312,28556133,control,7821
GS_DUP_CNV_10_26913726_26915875,chr10,26913726,26915875,control,2149
GS_DUP_CNV_X_26809987_26816189,chrX,26809987,26816189,control,6202
GS_DUP_CNV_6_26678509_26686542,chr6,26678509,26686542,control,8033
GS_DUP_CNV_16_26457170_27029947,chr16,26457170,27029947,control,572777
GS_DUP_CNV_20_26249966_26253647,chr20,26249966,26253647,control,3681
GS_DUP_CNV_20_26138653_26141765,chr20,26138653,26141765,control,3112
GS_DUP_CNV_20_25880136_25887590,chr20,25880136,25887590,control,7454
GS_DUP_CNV_20_25877278_25880385,chr20,25877278,25880385,control,3107
GS_DUP_CNV_8_25586584_25588929,chr8,25586584,25588929,control,2345
GS_DUP_CNV_8_25579060_25586383,chr8,25579060,25586383,control,7323
GS_DUP_CNV_17_25331435_25334025,chr17,25331435,25334025,control,2590
GS_DUP_CNV_17_25317638_25319759,chr17,25317638,25319759,control,2121
GS_DUP_CNV_11_25078470_25082313,chr11,25078470,25082313,control,3843
GS_DUP_CNV_13_24899772_24901951,chr13,24899772,24901951,control,2179
GS_DUP_CNV_15_24656389_24671105,chr15,24656389,24671105,control,14716
GS_DUP_CNV_15_24591040_24594647,chr15,24591040,24594647,control,3607
GS_DUP_CNV_19_24590185_24593711,chr19,24590185,24593711,control,3526
GS_DUP_CNV_15_24588915_24598440,chr15,24588915,24598440,control,9525
GS_DUP_CNV_15_24586006_24588482,chr15,24586006,24588482,control,2476
GS_DUP_CNV_19_24578585_24581428,chr19,24578585,24581428,control,2843
GS_DUP_CNV_15_24572955_24587141,chr15,24572955,24587141,control,14186
GS_DUP_CNV_15_24523759_24568570,chr15,24523759,24568570,control,44811
GS_DUP_CNV_15_24519646_24521806,chr15,24519646,24521806,control,2160
GS_DUP_CNV_15_24516352_24518534,chr15,24516352,24518534,control,2182
GS_DUP_CNV_15_24509970_24520150,chr15,24509970,24520150,control,10180
GS_DUP_CNV_22_23771635_23774339,chr22,23771635,23774339,control,2704
GS_DUP_CNV_13_23096661_23104485,chr13,23096661,23104485,control,7824
GS_DUP_CNV_16_22700375_22707161,chr16,22700375,22707161,control,6786
GS_DUP_CNV_16_22686063_22696262,chr16,22686063,22696262,control,10199
GS_DUP_CNV_16_22656664_22665862,chr16,22656664,22665862,control,9198
GS_DUP_CNV_16_22641364_22656263,chr16,22641364,22656263,control,14899
GS_DUP_CNV_16_22631106_22639043,chr16,22631106,22639043,control,7937
GS_DUP_CNV_16_22623605_22630905,chr16,22623605,22630905,control,7300
GS_DUP_CNV_16_22583874_22587649,chr16,22583874,22587649,cases,3775
GS_DUP_CNV_15_22561908_22590965,chr15,22561908,22590965,control,29057
GS_DUP_CNV_15_22555269_22558693,chr15,22555269,22558693,cases,3424
GS_DUP_CNV_16_22553187_22557356,chr16,22553187,22557356,control,4169
GS_DUP_CNV_16_22551140_22563883,chr16,22551140,22563883,cases,12743
GS_DUP_CNV_15_22550250_22557777,chr15,22550250,22557777,control,7527
GS_DUP_CNV_15_22546046_22548517,chr15,22546046,22548517,control,2471
GS_DUP_CNV_15_22543146_22545407,chr15,22543146,22545407,control,2261
GS_DUP_CNV_15_22534114_22536413,chr15,22534114,22536413,control,2299
GS_DUP_CNV_15_22534114_22545407,chr15,22534114,22545407,control,11293
GS_DUP_CNV_15_22530295_22532313,chr15,22530295,22532313,control,2018
GS_DUP_CNV_15_22514657_22529639,chr15,22514657,22529639,control,14982
GS_DUP_CNV_15_22508883_22514256,chr15,22508883,22514256,control,5373
GS_DUP_CNV_15_22500531_22506582,chr15,22500531,22506582,control,6051
GS_DUP_CNV_15_22497488_22507432,chr15,22497488,22507432,control,9944
GS_DUP_CNV_15_22495447_22497587,chr15,22495447,22497587,control,2140
GS_DUP_CNV_15_22491284_22499643,chr15,22491284,22499643,control,8359
GS_DUP_CNV_15_22487084_22490883,chr15,22487084,22490883,control,3799
GS_DUP_CNV_15_22473972_22486583,chr15,22473972,22486583,control,12611
GS_DUP_CNV_15_22462534_22467163,chr15,22462534,22467163,control,4629
GS_DUP_CNV_15_22444740_22475172,chr15,22444740,22475172,control,30432
GS_DUP_CNV_15_22426556_22438334,chr15,22426556,22438334,control,11778
GS_DUP_CNV_15_22426556_22449452,chr15,22426556,22449452,control,22896
GS_DUP_CNV_15_22420494_22423029,chr15,22420494,22423029,control,2535
GS_DUP_CNV_15_22383652_22423379,chr15,22383652,22423379,control,39727
GS_DUP_CNV_15_22362275_22372381,chr15,22362275,22372381,control,10106
GS_DUP_CNV_15_22361789_22364963,chr15,22361789,22364963,control,3174
GS_DUP_CNV_15_22353176_22355360,chr15,22353176,22355360,control,2184
GS_DUP_CNV_15_22346837_22358931,chr15,22346837,22358931,control,12094
GS_DUP_CNV_15_22297847_22332669,chr15,22297847,22332669,control,34822
GS_DUP_CNV_17_22016880_22026900,chr17,22016880,22026900,control,10020
GS_DUP_CNV_17_21996845_22157405,chr17,21996845,22157405,control,160560
GS_DUP_CNV_15_21925576_21941351,chr15,21925576,21941351,control,15775
GS_DUP_CNV_15_21919165_21925675,chr15,21919165,21925675,control,6510
GS_DUP_CNV_15_21913974_21917468,chr15,21913974,21917468,control,3494
GS_DUP_CNV_15_21908536_21923692,chr15,21908536,21923692,control,15156
GS_DUP_CNV_15_21900975_21910335,chr15,21900975,21910335,control,9360
GS_DUP_CNV_5_21567922_21569921,chr5,21567922,21569921,control,1999
GS_DUP_CNV_17_21543530_21545994,chr17,21543530,21545994,control,2464
GS_DUP_CNV_5_21540010_21548370,chr5,21540010,21548370,control,8360
GS_DUP_CNV_13_21538186_21540905,chr13,21538186,21540905,control,2719
GS_DUP_CNV_17_21535849_21540848,chr17,21535849,21540848,control,4999
GS_DUP_CNV_5_21522988_21526655,chr5,21522988,21526655,control,3667
GS_DUP_CNV_17_21522290_21524661,chr17,21522290,21524661,control,2371
GS_DUP_CNV_17_21508156_21512250,chr17,21508156,21512250,control,4094
GS_DUP_CNV_17_21507214_21510313,chr17,21507214,21510313,control,3099
GS_DUP_CNV_17_21424935_21442610,chr17,21424935,21442610,control,17675
GS_DUP_CNV_17_21353425_21402726,chr17,21353425,21402726,control,49301
GS_DUP_CNV_17_21347389_21351724,chr17,21347389,21351724,control,4335
GS_DUP_CNV_17_21346028_21350177,chr17,21346028,21350177,control,4149
GS_DUP_CNV_17_21345628_21348134,chr17,21345628,21348134,control,2506
GS_DUP_CNV_17_21345478_21351674,chr17,21345478,21351674,control,6196
GS_DUP_CNV_17_21334535_21339177,chr17,21334535,21339177,control,4642
GS_DUP_CNV_17_21331856_21335034,chr17,21331856,21335034,control,3178
GS_DUP_CNV_17_21327213_21329225,chr17,21327213,21329225,control,2012
GS_DUP_CNV_17_21325663_21330026,chr17,21325663,21330026,control,4363
GS_DUP_CNV_17_21321856_21325112,chr17,21321856,21325112,control,3256
GS_DUP_CNV_17_21321056_21323212,chr17,21321056,21323212,control,2156
GS_DUP_CNV_17_21317656_21319855,chr17,21317656,21319855,control,2199
GS_DUP_CNV_17_21313133_21315655,chr17,21313133,21315655,control,2522
GS_DUP_CNV_17_21303159_21331293,chr17,21303159,21331293,control,28134
GS_DUP_CNV_17_21240048_21254414,chr17,21240048,21254414,control,14366
GS_DUP_CNV_17_21231668_21234338,chr17,21231668,21234338,control,2670
GS_DUP_CNV_17_21225018_21230667,chr17,21225018,21230667,control,5649
GS_DUP_CNV_17_21224768_21227267,chr17,21224768,21227267,control,2499
GS_DUP_CNV_17_21222781_21226967,chr17,21222781,21226967,control,4186
GS_DUP_CNV_17_21209682_21212211,chr17,21209682,21212211,control,2529
GS_DUP_CNV_17_21205482_21209831,chr17,21205482,21209831,control,4349
GS_DUP_CNV_17_21203853_21208581,chr17,21203853,21208581,control,4728
GS_DUP_CNV_17_21201653_21204952,chr17,21201653,21204952,control,3299
GS_DUP_CNV_17_21169729_21213400,chr17,21169729,21213400,control,43671
GS_DUP_CNV_22_21032685_21038896,chr22,21032685,21038896,control,6211
GS_DUP_CNV_15_20873731_20878445,chr15,20873731,20878445,control,4714
GS_DUP_CNV_15_20869063_20873062,chr15,20869063,20873062,control,3999
GS_DUP_CNV_15_20865948_20873167,chr15,20865948,20873167,control,7219
GS_DUP_CNV_15_20862109_20864110,chr15,20862109,20864110,control,2001
GS_DUP_CNV_15_20861003_20868895,chr15,20861003,20868895,control,7892
GS_DUP_CNV_15_20854241_20856298,chr15,20854241,20856298,control,2057
GS_DUP_CNV_15_20851181_20868845,chr15,20851181,20868845,control,17664
GS_DUP_CNV_5_20832555_20834775,chr5,20832555,20834775,control,2220
GS_DUP_CNV_19_20828820_20950053,chr19,20828820,20950053,control,121233
GS_DUP_CNV_5_20803832_20806035,chr5,20803832,20806035,control,2203
GS_DUP_CNV_5_20802836_20805614,chr5,20802836,20805614,control,2778
GS_DUP_CNV_15_20621221_20623678,chr15,20621221,20623678,control,2457
GS_DUP_CNV_15_20619828_20627322,chr15,20619828,20627322,control,7494
GS_DUP_CNV_15_20600726_20615087,chr15,20600726,20615087,control,14361
GS_DUP_CNV_15_20594764_20602262,chr15,20594764,20602262,control,7498
GS_DUP_CNV_15_20589941_20594063,chr15,20589941,20594063,control,4122
GS_DUP_CNV_15_20576125_20578459,chr15,20576125,20578459,control,2334
GS_DUP_CNV_15_20563121_20567996,chr15,20563121,20567996,control,4875
GS_DUP_CNV_15_20556160_20572213,chr15,20556160,20572213,control,16053
GS_DUP_CNV_16_20496058_20501087,chr16,20496058,20501087,control,5029
GS_DUP_CNV_15_20436367_20439182,chr15,20436367,20439182,control,2815
GS_DUP_CNV_15_20436367_20442072,chr15,20436367,20442072,control,5705
GS_DUP_CNV_15_20434804_20437908,chr15,20434804,20437908,control,3104
GS_DUP_CNV_15_20425074_20434453,chr15,20425074,20434453,control,9379
GS_DUP_CNV_15_20423104_20427429,chr15,20423104,20427429,control,4325
GS_DUP_CNV_15_20419720_20424923,chr15,20419720,20424923,control,5203
GS_DUP_CNV_15_20406506_20419519,chr15,20406506,20419519,control,13013
GS_DUP_CNV_15_20395955_20409102,chr15,20395955,20409102,control,13147
GS_DUP_CNV_14_20385122_20397945,chr14,20385122,20397945,control,12823
GS_DUP_CNV_14_20379524_20382297,chr14,20379524,20382297,control,2773
GS_DUP_CNV_14_20363886_20374248,chr14,20363886,20374248,control,10362
GS_DUP_CNV_14_20359111_20368822,chr14,20359111,20368822,control,9711
GS_DUP_CNV_14_20354578_20366010,chr14,20354578,20366010,control,11432
GS_DUP_CNV_14_20334481_20346822,chr14,20334481,20346822,control,12341
GS_DUP_CNV_14_20323283_20330081,chr14,20323283,20330081,control,6798
GS_DUP_CNV_14_20301491_20313785,chr14,20301491,20313785,control,12294
GS_DUP_CNV_14_20293893_20296241,chr14,20293893,20296241,control,2348
GS_DUP_CNV_4_20253662_20255861,chr4,20253662,20255861,control,2199
GS_DUP_CNV_14_20241605_20256431,chr14,20241605,20256431,control,14826
GS_DUP_CNV_14_20235945_20238783,chr14,20235945,20238783,control,2838
GS_DUP_CNV_14_20204178_20215544,chr14,20204178,20215544,control,11366
GS_DUP_CNV_15_20074600_20076615,chr15,20074600,20076615,control,2015
GS_DUP_CNV_15_20074400_20079528,chr15,20074400,20079528,control,5128
GS_DUP_CNV_15_20061733_20064815,chr15,20061733,20064815,control,3082
GS_DUP_CNV_14_19812563_19819795,chr14,19812563,19819795,control,7232
GS_DUP_CNV_14_19810982_19817521,chr14,19810982,19817521,control,6539
GS_DUP_CNV_14_19792323_19796345,chr14,19792323,19796345,control,4022
GS_DUP_CNV_13_19644710_19649686,chr13,19644710,19649686,control,4976
GS_DUP_CNV_13_19643910_19646009,chr13,19643910,19646009,control,2099
GS_DUP_CNV_14_19121028_19124823,chr14,19121028,19124823,control,3795
GS_DUP_CNV_14_19116122_19121345,chr14,19116122,19121345,control,5223
GS_DUP_CNV_14_19093843_19098462,chr14,19093843,19098462,control,4619
GS_DUP_CNV_14_19089848_19093294,chr14,19089848,19093294,control,3446
GS_DUP_CNV_14_19084637_19094221,chr14,19084637,19094221,control,9584
GS_DUP_CNV_14_19078665_19081666,chr14,19078665,19081666,control,3001
GS_DUP_CNV_14_19075863_19077973,chr14,19075863,19077973,control,2110
GS_DUP_CNV_14_19070216_19073352,chr14,19070216,19073352,control,3136
GS_DUP_CNV_22_19012356_21466123,chr22,19012356,21466123,control,2453767
GS_DUP_CNV_16_18611122_18629809,chr16,18611122,18629809,control,18687
GS_DUP_CNV_16_18606663_18613653,chr16,18606663,18613653,control,6990
GS_DUP_CNV_16_18591423_18596225,chr16,18591423,18596225,control,4802
GS_DUP_CNV_16_18573855_18577154,chr16,18573855,18577154,control,3299
GS_DUP_CNV_16_18570538_18605335,chr16,18570538,18605335,control,34797
GS_DUP_CNV_17_18513264_18517757,chr17,18513264,18517757,control,4493
GS_DUP_CNV_1_17234249_17237617,chr1,17234249,17237617,control,3368
GS_DUP_CNV_1_17231549_17233748,chr1,17231549,17233748,control,2199
GS_DUP_CNV_1_17228807_17233748,chr1,17228807,17233748,cases,4941
GS_DUP_CNV_1_17043858_17051729,chr1,17043858,17051729,control,7871
GS_DUP_CNV_1_17038464_17043457,chr1,17038464,17043457,control,4993
GS_DUP_CNV_1_17038464_17047322,chr1,17038464,17047322,control,8858
GS_DUP_CNV_1_17036629_17039573,chr1,17036629,17039573,control,2944
GS_DUP_CNV_1_17032367_17042073,chr1,17032367,17042073,control,9706
GS_DUP_CNV_1_17026195_17028478,chr1,17026195,17028478,control,2283
GS_DUP_CNV_1_17026195_17034877,chr1,17026195,17034877,control,8682
GS_DUP_CNV_1_17017475_17025717,chr1,17017475,17025717,control,8242
GS_DUP_CNV_1_17016325_17022507,chr1,17016325,17022507,control,6182
GS_DUP_CNV_1_17013032_17016624,chr1,17013032,17016624,control,3592
GS_DUP_CNV_4_16976322_16986702,chr4,16976322,16986702,control,10380
GS_DUP_CNV_1_16967586_16972275,chr1,16967586,16972275,control,4689
GS_DUP_CNV_1_16962157_16967085,chr1,16962157,16967085,control,4928
GS_DUP_CNV_22_16956564_16958933,chr22,16956564,16958933,control,2369
GS_DUP_CNV_1_16951966_16955835,chr1,16951966,16955835,cases,3869
GS_DUP_CNV_1_16951816_16959200,chr1,16951816,16959200,cases,7384
GS_DUP_CNV_1_16938616_16941534,chr1,16938616,16941534,cases,2918
GS_DUP_CNV_1_16931997_16937340,chr1,16931997,16937340,cases,5343
GS_DUP_CNV_22_16883167_16885229,chr22,16883167,16885229,control,2062
GS_DUP_CNV_1_16871272_16877454,chr1,16871272,16877454,control,6182
GS_DUP_CNV_17_16771362_16775967,chr17,16771362,16775967,control,4605
GS_DUP_CNV_17_16697394_16708685,chr17,16697394,16708685,control,11291
GS_DUP_CNV_17_16697087_16704603,chr17,16697087,16704603,control,7516
GS_DUP_CNV_16_16693357_16695426,chr16,16693357,16695426,control,2069
GS_DUP_CNV_17_16656347_16700157,chr17,16656347,16700157,cases,43810
GS_DUP_CNV_17_16656347_16662979,chr17,16656347,16662979,cases,6632
GS_DUP_CNV_3_16406594_16408969,chr3,16406594,16408969,control,2375
GS_DUP_CNV_1_16370400_16381043,chr1,16370400,16381043,control,10643
GS_DUP_CNV_1_16364606_16370349,chr1,16364606,16370349,control,5743
GS_DUP_CNV_1_16347954_16354572,chr1,16347954,16354572,control,6618
GS_DUP_CNV_22_16052617_16055219,chr22,16052617,16055219,control,2602
GS_DUP_CNV_22_16050687_16057580,chr22,16050687,16057580,control,6893
GS_DUP_CNV_19_15805283_15831761,chr19,15805283,15831761,control,26478
GS_DUP_CNV_19_15780412_15792797,chr19,15780412,15792797,control,12385
GS_DUP_CNV_17_15656300_15658760,chr17,15656300,15658760,control,2460
GS_DUP_CNV_17_15656300_15670091,chr17,15656300,15670091,control,13791
GS_DUP_CNV_17_15652884_15656786,chr17,15652884,15656786,control,3902
GS_DUP_CNV_17_15640930_15648675,chr17,15640930,15648675,control,7745
GS_DUP_CNV_17_15635950_15691236,chr17,15635950,15691236,control,55286
GS_DUP_CNV_17_15634998_15639852,chr17,15634998,15639852,control,4854
GS_DUP_CNV_17_15631849_15639216,chr17,15631849,15639216,control,7367
GS_DUP_CNV_21_15436372_15439864,chr21,15436372,15439864,control,3492
GS_DUP_CNV_16_15270214_15276559,chr16,15270214,15276559,control,6345
GS_DUP_CNV_16_15242269_15245963,chr16,15242269,15245963,control,3694
GS_DUP_CNV_16_15234859_15237203,chr16,15234859,15237203,control,2344
GS_DUP_CNV_16_15229511_15245287,chr16,15229511,15245287,control,15776
GS_DUP_CNV_16_15124740_15158922,chr16,15124740,15158922,control,34182
GS_DUP_CNV_16_15113874_15123481,chr16,15113874,15123481,control,9607
GS_DUP_CNV_16_15108267_15111690,chr16,15108267,15111690,cases,3423
GS_DUP_CNV_16_15099310_15105342,chr16,15099310,15105342,control,6032
GS_DUP_CNV_16_15097308_15100711,chr16,15097308,15100711,cases,3403
GS_DUP_CNV_16_15094903_15098809,chr16,15094903,15098809,control,3906
GS_DUP_CNV_16_15081767_15091171,chr16,15081767,15091171,control,9404
GS_DUP_CNV_16_15079217_15086324,chr16,15079217,15086324,cases,7107
GS_DUP_CNV_16_15075782_15078220,chr16,15075782,15078220,cases,2438
GS_DUP_CNV_16_15071844_15077124,chr16,15071844,15077124,control,5280
GS_DUP_CNV_16_15065700_15074888,chr16,15065700,15074888,cases,9188
GS_DUP_CNV_16_15063582_15066271,chr16,15063582,15066271,cases,2689
GS_DUP_CNV_16_15059118_15064193,chr16,15059118,15064193,control,5075
GS_DUP_CNV_16_15056618_15060556,chr16,15056618,15060556,cases,3938
GS_DUP_CNV_16_15050565_15053717,chr16,15050565,15053717,cases,3152
GS_DUP_CNV_16_15049441_15053717,chr16,15049441,15053717,control,4276
GS_DUP_CNV_10_14984061_15010278,chr10,14984061,15010278,control,26217
GS_DUP_CNV_21_14442202_14444653,chr21,14442202,14444653,control,2451
GS_DUP_CNV_21_14434271_14437810,chr21,14434271,14437810,control,3539
GS_DUP_CNV_21_14428984_14432449,chr21,14428984,14432449,control,3465
GS_DUP_CNV_21_14419886_14422896,chr21,14419886,14422896,control,3010
GS_DUP_CNV_21_14419455_14424752,chr21,14419455,14424752,control,5297
GS_DUP_CNV_21_14414328_14418052,chr21,14414328,14418052,control,3724
GS_DUP_CNV_21_14401085_14403861,chr21,14401085,14403861,control,2776
GS_DUP_CNV_21_14395797_14400834,chr21,14395797,14400834,control,5037
GS_DUP_CNV_21_14391025_14395628,chr21,14391025,14395628,control,4603
GS_DUP_CNV_21_14385134_14387600,chr21,14385134,14387600,control,2466
GS_DUP_CNV_18_14250301_14262468,chr18,14250301,14262468,control,12167
GS_DUP_CNV_17_14089298_15488440,chr17,14089298,15488440,control,1399142
GS_DUP_CNV_1_13179454_13181903,chr1,13179454,13181903,control,2449
GS_DUP_CNV_8_12440893_12446764,chr8,12440893,12446764,control,5871
GS_DUP_CNV_8_12436799_12442346,chr8,12436799,12442346,cases,5547
GS_DUP_CNV_8_12430057_12432688,chr8,12430057,12432688,cases,2631
GS_DUP_CNV_8_12427752_12432788,chr8,12427752,12432788,cases,5036
GS_DUP_CNV_8_12417142_12424116,chr8,12417142,12424116,cases,6974
GS_DUP_CNV_8_12409143_12414198,chr8,12409143,12414198,control,5055
GS_DUP_CNV_8_12402549_12411180,chr8,12402549,12411180,control,8631
GS_DUP_CNV_8_12401973_12405048,chr8,12401973,12405048,cases,3075
GS_DUP_CNV_8_12397285_12400355,chr8,12397285,12400355,cases,3070
GS_DUP_CNV_8_12395736_12405048,chr8,12395736,12405048,control,9312
GS_DUP_CNV_17_12297757_12313224,chr17,12297757,12313224,control,15467
GS_DUP_CNV_17_11875422_11886607,chr17,11875422,11886607,control,11185
GS_DUP_CNV_17_11480080_11499190,chr17,11480080,11499190,control,19110
GS_DUP_CNV_17_11440234_11485003,chr17,11440234,11485003,control,44769
GS_DUP_CNV_17_11262691_11350660,chr17,11262691,11350660,control,87969
GS_DUP_CNV_12_11189594_11192448,chr12,11189594,11192448,control,2854
GS_DUP_CNV_17_11183214_11236473,chr17,11183214,11236473,control,53259
GS_DUP_CNV_21_10991917_10999750,chr21,10991917,10999750,control,7833
GS_DUP_CNV_21_10990411_10993877,chr21,10990411,10993877,control,3466
GS_DUP_CNV_21_10969475_10989928,chr21,10969475,10989928,control,20453
GS_DUP_CNV_21_10969425_10973376,chr21,10969425,10973376,control,3951
GS_DUP_CNV_21_10954215_10973376,chr21,10954215,10973376,control,19161
GS_DUP_CNV_21_10954165_10962660,chr21,10954165,10962660,control,8495
GS_DUP_CNV_21_10944956_10951640,chr21,10944956,10951640,control,6684
GS_DUP_CNV_21_10939914_10942200,chr21,10939914,10942200,control,2286
GS_DUP_CNV_21_10939614_10944855,chr21,10939614,10944855,control,5241
GS_DUP_CNV_21_10932890_10939813,chr21,10932890,10939813,control,6923
GS_DUP_CNV_21_10928109_10936537,chr21,10928109,10936537,control,8428
GS_DUP_CNV_21_10925291_10930533,chr21,10925291,10930533,control,5242
GS_DUP_CNV_21_10917553_10927794,chr21,10917553,10927794,control,10241
GS_DUP_CNV_21_10916067_10922358,chr21,10916067,10922358,control,6291
GS_DUP_CNV_21_10912666_10915465,chr21,10912666,10915465,control,2799
GS_DUP_CNV_21_10912432_10919194,chr21,10912432,10919194,control,6762
GS_DUP_CNV_21_10902897_10912231,chr21,10902897,10912231,control,9334
GS_DUP_CNV_21_10897730_10905605,chr21,10897730,10905605,control,7875
GS_DUP_CNV_21_10887930_10892208,chr21,10887930,10892208,control,4278
GS_DUP_CNV_21_10876386_10886007,chr21,10876386,10886007,control,9621
GS_DUP_CNV_21_10871526_10874553,chr21,10871526,10874553,control,3027
GS_DUP_CNV_21_10870398_10873153,chr21,10870398,10873153,control,2755
GS_DUP_CNV_21_10868043_10873953,chr21,10868043,10873953,control,5910
GS_DUP_CNV_21_10639317_10644129,chr21,10639317,10644129,control,4812
GS_DUP_CNV_21_10622465_10627585,chr21,10622465,10627585,control,5120
GS_DUP_CNV_21_10617404_10621492,chr21,10617404,10621492,control,4088
GS_DUP_CNV_21_10616270_10623210,chr21,10616270,10623210,control,6940
GS_DUP_CNV_21_10584946_10589506,chr21,10584946,10589506,control,4560
GS_DUP_CNV_21_10579800_10583276,chr21,10579800,10583276,control,3476
GS_DUP_CNV_21_10571414_10575044,chr21,10571414,10575044,control,3630
GS_DUP_CNV_21_10566089_10570714,chr21,10566089,10570714,control,4625
GS_DUP_CNV_21_10530100_10533720,chr21,10530100,10533720,control,3620
GS_DUP_CNV_21_10529599_10535558,chr21,10529599,10535558,control,5959
GS_DUP_CNV_21_10528401_10532312,chr21,10528401,10532312,control,3911
GS_DUP_CNV_21_10519189_10522210,chr21,10519189,10522210,control,3021
GS_DUP_CNV_21_10518857_10528550,chr21,10518857,10528550,control,9693
GS_DUP_CNV_21_10513771_10516225,chr21,10513771,10516225,control,2454
GS_DUP_CNV_21_10511956_10522260,chr21,10511956,10522260,control,10304
GS_DUP_CNV_21_10494887_10505175,chr21,10494887,10505175,control,10288
GS_DUP_CNV_21_10465246_10472571,chr21,10465246,10472571,control,7325
GS_DUP_CNV_21_10437846_10444967,chr21,10437846,10444967,control,7121
GS_DUP_CNV_21_10427642_10434906,chr21,10427642,10434906,control,7264
GS_DUP_CNV_10_10306915_10309934,chr10,10306915,10309934,control,3019
GS_DUP_CNV_4_9499479_9504762,chr4,9499479,9504762,control,5283
GS_DUP_CNV_21_9411389_9418105,chr21,9411389,9418105,control,6716
GS_DUP_CNV_12_8957546_8964419,chr12,8957546,8964419,control,6873
GS_DUP_CNV_3_8823529_8835074,chr3,8823529,8835074,control,11545
GS_DUP_CNV_X_8123539_8126177,chrX,8123539,8126177,control,2638
GS_DUP_CNV_X_8121272_8126177,chrX,8121272,8126177,control,4905
GS_DUP_CNV_X_7942872_7963915,chrX,7942872,7963915,control,21043
GS_DUP_CNV_X_7876609_7895542,chrX,7876609,7895542,control,18933
GS_DUP_CNV_X_7782287_7805834,chrX,7782287,7805834,control,23547
GS_DUP_CNV_X_7569683_7622649,chrX,7569683,7622649,control,52966
GS_DUP_CNV_X_7530429_7537808,chrX,7530429,7537808,control,7379
GS_DUP_CNV_X_7527089_7532728,chrX,7527089,7532728,control,5639
GS_DUP_CNV_6_7426502_7444038,chr6,7426502,7444038,control,17536
GS_DUP_CNV_X_7300633_7329822,chrX,7300633,7329822,control,29189
GS_DUP_CNV_4_7165958_7168357,chr4,7165958,7168357,control,2399
GS_DUP_CNV_X_6909476_7234885,chrX,6909476,7234885,control,325409
GS_DUP_CNV_11_6899014_6905159,chr11,6899014,6905159,control,6145
GS_DUP_CNV_X_6888395_6902068,chrX,6888395,6902068,cases,13673
GS_DUP_CNV_8_6877665_6879829,chr8,6877665,6879829,control,2164
GS_DUP_CNV_X_6831975_6877297,chrX,6831975,6877297,control,45322
GS_DUP_CNV_X_6770081_6785407,chrX,6770081,6785407,control,15326
GS_DUP_CNV_17_6730639_6752952,chr17,6730639,6752952,control,22313
GS_DUP_CNV_X_6668841_6750264,chrX,6668841,6750264,control,81423
GS_DUP_CNV_X_6616301_6652674,chrX,6616301,6652674,control,36373
GS_DUP_CNV_X_6601874_6615350,chrX,6601874,6615350,control,13476
GS_DUP_CNV_X_6453051_6473158,chrX,6453051,6473158,control,20107
GS_DUP_CNV_17_5991656_6001592,chr17,5991656,6001592,control,9936
GS_DUP_CNV_X_5356214_5373442,chrX,5356214,5373442,control,17228
GS_DUP_CNV_X_5179143_5185989,chrX,5179143,5185989,control,6846
GS_DUP_CNV_10_4289330_4292957,chr10,4289330,4292957,control,3627
GS_DUP_CNV_4_4018099_4023706,chr4,4018099,4023706,control,5607
GS_DUP_CNV_4_4014638_4022192,chr4,4014638,4022192,control,7554
GS_DUP_CNV_4_3632804_3636476,chr4,3632804,3636476,control,3672
GS_DUP_CNV_4_3630954_3634603,chr4,3630954,3634603,control,3649
GS_DUP_CNV_4_3627557_3632503,chr4,3627557,3632503,control,4946
GS_DUP_CNV_4_3625188_3628456,chr4,3625188,3628456,control,3268
GS_DUP_CNV_4_3619588_3625087,chr4,3619588,3625087,control,5499
GS_DUP_CNV_4_3608827_3613376,chr4,3608827,3613376,control,4549
GS_DUP_CNV_4_3597285_3610976,chr4,3597285,3610976,control,13691
GS_DUP_CNV_4_3587219_3590518,chr4,3587219,3590518,control,3299
GS_DUP_CNV_4_3575638_3581464,chr4,3575638,3581464,control,5826
GS_DUP_CNV_4_3573583_3597734,chr4,3573583,3597734,control,24151
GS_DUP_CNV_5_3218944_3223517,chr5,3218944,3223517,control,4573
GS_DUP_CNV_5_2895539_2898488,chr5,2895539,2898488,control,2949
GS_DUP_CNV_X_2714176_2718750,chrX,2714176,2718750,control,4574
GS_DUP_CNV_X_2699332_2712780,chrX,2699332,2712780,control,13448
GS_DUP_CNV_8_2557287_2560330,chr8,2557287,2560330,control,3043
GS_DUP_CNV_8_2449033_2529547,chr8,2449033,2529547,control,80514
GS_DUP_CNV_8_2418493_2420617,chr8,2418493,2420617,control,2124
GS_DUP_CNV_8_2364556_2483379,chr8,2364556,2483379,control,118823
GS_DUP_CNV_8_2279997_2287268,chr8,2279997,2287268,control,7271
GS_DUP_CNV_8_2269711_2279182,chr8,2269711,2279182,control,9471
GS_DUP_CNV_8_2266759_2273289,chr8,2266759,2273289,control,6530
GS_DUP_CNV_8_2243360_2245709,chr8,2243360,2245709,control,2349
GS_DUP_CNV_8_2239864_2244259,chr8,2239864,2244259,control,4395
GS_DUP_CNV_8_2236713_2270493,chr8,2236713,2270493,control,33780
GS_DUP_CNV_8_2224073_2230013,chr8,2224073,2230013,control,5940
GS_DUP_CNV_8_2220259_2222972,chr8,2220259,2222972,control,2713
GS_DUP_CNV_8_2216099_2219081,chr8,2216099,2219081,control,2982
GS_DUP_CNV_8_2206913_2215317,chr8,2206913,2215317,control,8404
GS_DUP_CNV_8_2205313_2210012,chr8,2205313,2210012,control,4699
GS_DUP_CNV_8_2198763_2205062,chr8,2198763,2205062,control,6299
GS_DUP_CNV_8_2195384_2200912,chr8,2195384,2200912,control,5528
GS_DUP_CNV_X_1749253_1753256,chrX,1749253,1753256,control,4003
GS_DUP_CNV_X_1742732_1745466,chrX,1742732,1745466,control,2734
GS_DUP_CNV_X_1729229_1737769,chrX,1729229,1737769,control,8540
GS_DUP_CNV_2_855907_858227,chr2,855907,858227,control,2320
GS_DUP_CNV_1_736236_742745,chr1,736236,742745,control,6509
GS_DUP_CNV_1_732279_734520,chr1,732279,734520,control,2241
GS_DUP_CNV_1_712626_725897,chr1,712626,725897,control,13271
GS_DUP_CNV_19_309342_311785,chr19,309342,311785,control,2443
GS_DUP_CNV_6_305451_334260,chr6,305451,334260,control,28809
GS_DUP_CNV_6_295565_310389,chr6,295565,310389,control,14824
GS_DUP_CNV_6_295565_382563,chr6,295565,382563,control,86998
GS_DUP_CNV_6_256587_279772,chr6,256587,279772,control,23185
GS_DUP_CNV_7_214891_217058,chr7,214891,217058,control,2167
GS_DUP_CNV_12_177531_186268,chr12,177531,186268,control,8737
GS_DUP_CNV_12_170119_176005,chr12,170119,176005,control,5886
GS_DUP_CNV_12_167588_169687,chr12,167588,169687,control,2099
GS_DUP_CNV_12_165288_170328,chr12,165288,170328,control,5040
GS_DUP_CNV_12_162688_168987,chr12,162688,168987,control,6299
GS_DUP_CNV_9_114329_117863,chr9,114329,117863,cases,3534
GS_DUP_CNV_9_113013_117656,chr9,113013,117656,control,4643
GS_DUP_CNV_9_112106_115954,chr9,112106,115954,control,3848
GS_DUP_CNV_3_109682_130238,chr3,109682,130238,control,20556
GS_DUP_CNV_3_85182_95465,chr3,85182,95465,control,10283
GS_DUP_CNV_12_82550_84706,chr12,82550,84706,control,2156
GS_DUP_CNV_3_73396_80362,chr3,73396,80362,control,6966
GS_DUP_CNV_3_65441_68988,chr3,65441,68988,control,3547
GS_DUP_CNV_2_13226_24109,chr2,13226,24109,control,10883
GS_DUP_CNV_17_1_21303226,chr17,1,21303226,control,21303225